0/val_00000000.JPEG	0
1/val_00000001.JPEG	1
1/val_00000002.JPEG	1
0/val_00000003.JPEG	0
1/val_00000004.JPEG	1
1/val_00000005.JPEG	1
1/val_00000006.JPEG	1
1/val_00000007.JPEG	1
1/val_00000008.JPEG	1
1/val_00000009.JPEG	1
1/val_00000010.JPEG	1
0/val_00000011.JPEG	0
1/val_00000012.JPEG	1
1/val_00000013.JPEG	1
0/val_00000014.JPEG	0
1/val_00000015.JPEG	1
1/val_00000016.JPEG	1
1/val_00000017.JPEG	1
0/val_00000018.JPEG	0
1/val_00000019.JPEG	1
0/val_00000020.JPEG	0
1/val_00000021.JPEG	1
1/val_00000022.JPEG	1
1/val_00000023.JPEG	1
0/val_00000024.JPEG	0
1/val_00000025.JPEG	1
1/val_00000026.JPEG	1
1/val_00000027.JPEG	1
0/val_00000028.JPEG	0
1/val_00000029.JPEG	1
0/val_00000030.JPEG	0
1/val_00000031.JPEG	1
1/val_00000032.JPEG	1
0/val_00000033.JPEG	0
1/val_00000034.JPEG	1
1/val_00000035.JPEG	1
1/val_00000036.JPEG	1
1/val_00000037.JPEG	1
1/val_00000038.JPEG	1
1/val_00000039.JPEG	1
1/val_00000040.JPEG	1
1/val_00000041.JPEG	1
1/val_00000042.JPEG	1
1/val_00000043.JPEG	1
0/val_00000044.JPEG	0
0/val_00000045.JPEG	0
1/val_00000046.JPEG	1
0/val_00000047.JPEG	0
1/val_00000048.JPEG	1
0/val_00000049.JPEG	0
1/val_00000050.JPEG	1
1/val_00000051.JPEG	1
1/val_00000052.JPEG	1
1/val_00000053.JPEG	1
1/val_00000054.JPEG	1
1/val_00000055.JPEG	1
1/val_00000056.JPEG	1
1/val_00000057.JPEG	1
1/val_00000058.JPEG	1
0/val_00000059.JPEG	0
1/val_00000060.JPEG	1
1/val_00000061.JPEG	1
1/val_00000062.JPEG	1
0/val_00000063.JPEG	0
1/val_00000064.JPEG	1
1/val_00000065.JPEG	1
0/val_00000066.JPEG	0
0/val_00000067.JPEG	0
1/val_00000068.JPEG	1
1/val_00000069.JPEG	1
1/val_00000070.JPEG	1
0/val_00000071.JPEG	0
1/val_00000072.JPEG	1
0/val_00000073.JPEG	0
0/val_00000074.JPEG	0
1/val_00000075.JPEG	1
1/val_00000076.JPEG	1
1/val_00000077.JPEG	1
